XXXXXXXXXXXXXX
XXXXXXXXXXXXXX
XXXXXXXXXXXXXX
XXXXXXXXXXXXXX
XXXXXXXXXXXXXX
XXXXXXXXXXXXXX
XXXXXXXXXXXBXX
GGGGGGGGGGGTGG
TTTTTTTTTTTTTT
TTTTTTTTTTTTTT